private void buildRecord(ResultSet rs) throws SQLException {
    id = rs.getInt("contact_id");
    isOrganization = rs.getBoolean("is_organization");
    salutation = rs.getString("salutation");
    firstName = rs.getString("first_name");
    middleName = rs.getString("middle_name");
    lastName = rs.getString("last_name");
    suffixName = rs.getString("suffix_name");
    organization = rs.getString("organization");
    fileAs = rs.getString("file_as");
    jobTitle = rs.getString("job_title");
    role = rs.getString("role");
    email1 = rs.getString("email1");
    email2 = rs.getString("email2");
    email3 = rs.getString("email3");
    homePhone = rs.getString("home_phone");
    homePhoneExt = rs.getString("home_phone_ext");
    home2Phone = rs.getString("home2_phone");
    home2PhoneExt = rs.getString("home2_phone_ext");
    homeFax = rs.getString("home_fax");
    businessPhone = rs.getString("business_phone");
    businessPhoneExt = rs.getString("business_phone_ext");
    business2Phone = rs.getString("business2_phone");
    business2PhoneExt = rs.getString("business2_phone_ext");
    businessFax = rs.getString("business_fax");
    mobilePhone = rs.getString("mobile_phone");
    pagerNumber = rs.getString("pager_number");
    carPhone = rs.getString("car_phone");
    radioPhone = rs.getString("radio_phone");
    webPage = rs.getString("web_page");
    nickname = rs.getString("nickname");
    comments = rs.getString("comments");
    owner = DatabaseUtils.getInt(rs, "owner");
    global = rs.getBoolean("global");
    entered = rs.getTimestamp("entered");
    enteredBy = rs.getInt("enteredby");
    modified = rs.getTimestamp("modified");
    modifiedBy = rs.getInt("modifiedby");
    addressLine1 = rs.getString("addrline1");
    addressLine2 = rs.getString("addrline2");
    addressLine3 = rs.getString("addrline3");
    city = rs.getString("city");
    state = rs.getString("state");
    country = rs.getString("country");
    postalCode = rs.getString("postalcode");
    latitude = DatabaseUtils.getDouble(rs, "latitude", 0.0);
    longitude = DatabaseUtils.getDouble(rs, "longitude", 0.0);
}
