private void buildRecord(ResultSet rs) throws SQLException {
    allowGuests = rs.getBoolean("allow_guests");
    showNews = rs.getBoolean("news_enabled");
    showDetails = rs.getBoolean("details_enabled");
    showTeam = rs.getBoolean("team_enabled");
    showPlan = rs.getBoolean("plan_enabled");
    showLists = rs.getBoolean("lists_enabled");
    showDiscussion = rs.getBoolean("discussion_enabled");
    showTickets = rs.getBoolean("tickets_enabled");
    showDocuments = rs.getBoolean("documents_enabled");
    labelNews = rs.getString("news_label");
    labelDetails = rs.getString("details_label");
    labelTeam = rs.getString("team_label");
    labelPlan = rs.getString("plan_label");
    labelLists = rs.getString("lists_label");
    labelDiscussion = rs.getString("discussion_label");
    labelTickets = rs.getString("tickets_label");
    labelDocuments = rs.getString("documents_label");
    allowParticipants = rs.getBoolean("allows_user_observers");
    showCalendar = rs.getBoolean("calendar_enabled");
    labelCalendar = rs.getString("calendar_label");
    showWiki = rs.getBoolean("wiki_enabled");
    labelWiki = rs.getString("wiki_label");
    orderDashboard = rs.getInt("dashboard_order");
    orderNews = rs.getInt("news_order");
    orderCalendar = rs.getInt("calendar_order");
    orderWiki = rs.getInt("wiki_order");
    orderDiscussion = rs.getInt("discussion_order");
    orderDocuments = rs.getInt("documents_order");
    orderLists = rs.getInt("lists_order");
    orderPlan = rs.getInt("plan_order");
    orderTickets = rs.getInt("tickets_order");
    orderTeam = rs.getInt("team_order");
    orderDetails = rs.getInt("details_order");
    showDashboard = rs.getBoolean("dashboard_enabled");
    labelDashboard = rs.getString("dashboard_label");
    descriptionDashboard = rs.getString("dashboard_description");
    descriptionNews = rs.getString("news_description");
    descriptionCalendar = rs.getString("calendar_description");
    descriptionWiki = rs.getString("wiki_description");
    descriptionDiscussion = rs.getString("discussion_description");
    descriptionDocuments = rs.getString("documents_description");
    descriptionLists = rs.getString("lists_description");
    descriptionPlan = rs.getString("plan_description");
    descriptionTickets = rs.getString("tickets_description");
    descriptionTeam = rs.getString("team_description");
    showBadges = rs.getBoolean("badges_enabled");
    labelBadges = rs.getString("badges_label");
    orderBadges = rs.getInt("badges_order");
    descriptionBadges = rs.getString("badges_description");
    showReviews = rs.getBoolean("reviews_enabled");
    labelReviews = rs.getString("reviews_label");
    orderReviews = rs.getInt("reviews_order");
    descriptionReviews = rs.getString("reviews_description");
    showClassifieds = rs.getBoolean("classifieds_enabled");
    labelClassifieds = rs.getString("classifieds_label");
    orderClassifieds = rs.getInt("classifieds_order");
    descriptionClassifieds = rs.getString("classifieds_description");
    showAds = rs.getBoolean("ads_enabled");
    labelAds = rs.getString("ads_label");
    orderAds = rs.getInt("ads_order");
    descriptionAds = rs.getString("ads_description");
    membershipRequired = rs.getBoolean("membership_required");
    showProfile = rs.getBoolean("profile_enabled");
    labelProfile = rs.getString("profile_label");
    orderProfile = rs.getInt("profile_order");
    descriptionProfile = rs.getString("profile_description");
    showMessages = rs.getBoolean("messages_enabled");
    labelMessages = rs.getString("messages_label");
    orderMessages = rs.getInt("messages_order");
    descriptionMessages = rs.getString("messages_description");
    showWebcasts = rs.getBoolean("webcasts_enabled");
    labelWebcasts = rs.getString("webcasts_label");
    orderWebcasts = rs.getInt("webcasts_order");
    descriptionWebcasts = rs.getString("webcasts_description");
// NOTE: update the project buildRecord as well
}
